Valeur : Mnémotechnique
1 : Le Hun naissant mène un mehnir vert au Masai riant activement.
2 : Le feu marital nyctalope conjugue le paganisme.
3 : La foi en l'acné michetonne pour que le wiki de l'ohmètre indique les ilôts.
4 : Le chat est un pecnot mnémotechnique car il est à la fois nordiste et sudiste et allie nécrophages, morts et kassos.
5 : Le sphynx asperge le débrouillard ramdam que fait le vacancier qui interviewe l'alliance entre le scientifique et le gars flottant.
6 : la scie pacsée avec Kyle le Vietnamien s'alcoolise avec le chamsin.
7 : la chaussette discontinue s'arrange avec l'okapi qui maline Tex.
8 : l'huître montagnarde du fromton d'Hollywood idéalise le corbeau utile et bienveillant et l'erlenmeyer d'azote.
9 : L'oeuf pacifiste fait du water-polo avec l'oracle cabotin.
Maine : mène
New-Hampshire : mehnir
Vermont : vert
Massachusett : Masai
Rhode Island : riant
Connecticut : activement
New-York : nyctalope
New-Jersey : conjugue
Pennsylvanie : paganisme
Michigan : michetonne
Wisconsin : wiki
Ohio : ohmètre
Indiana : indique
Illinois : îlots
Minnesota : mnémotechnique
Dakota du Nord : nordistes
Dakota du Sud : sudistes
Iowa : allie
Nebraska : nécrophages
Missouri : morts
Kansas : kassos
Delaware : débrouillard
Maryland : ramdam
Virginie : vacancier
Virginie occidentale : intervievewe
Caroline du Nord : alliance
Caroline du Sud : scientifique
Géorgie : gars
Floride : flottant
Kentuchy : Kyle
Tennessee : vietnamien
Alabama : s'alcoolise
Mississipi : chamsin
Arkansas : s'arrange
Oklahoma : okapi
Louisiane : lamine
Texas : Tex
Montana : fromton
Wyoming : Hollywood
Idaho : idéalise
Colorado : corbeau
Utah : utile
Nevada : bienveillant
Nouveau-Mexique : erlenmeyer
Arizona : azote
Washington : water-polo
Oregon ; oracle
Californie : cabotin
